1111111111
100010C001
1000111001
1000001001
1000000001
100C000001
1000000001
100000C001
1E00000001
1111111111
