1111111111
1E0010C001
1000111001
1P00001001
1000000001
100C000001
1000000001
100000C001
1E0000000
1111111111
