1111111111111111111111111111111111111
1000000P000000000000000000C00000000E1
1000000000000000C00000000000000C00001
1111111111111111111111111111111111111